00001111111111111111
00001001000100000001
11111111000111111111
10001001100000000000
11111100100011111110
10000100111110000010
10000100100000000010
11111100100001110010
00100000100001011110
00100000100001001000
11111111111111001011
01000000100000001010
01000011111111111010
01000010100100000110
01000010100100011100
11111110100100010100
10010011101111111110
10011110111000010010
10010000010000010010
11110000011111110010
