00000000000000000000
00001001101100000000
01111111000111111111
01001001100000000100
01111100100011111110
01000100111110000010
01110100100000000010
01000000100001110010
00100000100001011110
00100000100001000000
11111111111001001110
01000000100001001010
01000011111101111010
01000010100100001110
01000010100100000100
01011110100100000100
01010011101111111110
01011110111000010010
01110000000000011110
00000000000000000000
